15, 15
...............
...............
.S.##########..
............#..
............#..
............#..
............#..
............#..
............#..
............#..
............#..
...##########..
...............
..........F....
...............