20, 10
...######......##...
.S.#....#.........#.
...#..#...#...####..
.#...####.#.........
.#####....#.........
.....#..#.###...#...
......###...#......#
.#....#....##.......
.##...###.##...##.#.
..#............#F.#.