20, 20
....................
.S..................
....................
#########...........
....................
..../////...........
............////....
////.::::::::.......
::::.:::::::////////
::::.:::::::::://///
................////
....................
....................
....................
....................
/////////..::::::...
.......///....::::::
..F.................
....................
....................